This script will install Zentyal Development Edition 4.2 with all modules.
If you don't want to install all of the modules, but only some, you can, for example, run:

sudo apt-get install zentyal-mail


list of Zentyal packages:

zentyal-all – Zentyal – All Component Modules (all Profiles)
zentyal-office – Zentyal Office Suite (Profile)
zentyal-antivirus – Zentyal Antivirus
zentyal-dns – Zentyal DNS
zentyal-ebackup – Zentyal Backup
zentyal-firewall – Zentyal Firewall Services
zentyal-ntp – NTP Services
zentyal-remoteservices – Zentyal Cloud Client
zentyal-samba – Zentyal File Sharing and Domain Services
zentyal-communication – Zentyal Communications Suite
zentyal-jabber – Zentyal Jabber (Instant Messaging)
zentyal-mail – Zentyal Mail Service
zentyal-mailfilter – Zentyal Mail Filter
zentyal-gateway – Zentyal Gateway Suite
zentyal-l7-protocols – Zentyal Layer-7 Filter
zentyal-squid – HTTP Proxy
zentyal-trafficshaping – Zentyal Traffic Shaping
zentyal-infrastructure – Zentyal Network Infrastructure Suite
zentyal-ca – Zentyal Certificate Authority
zentyal-dhcp – DHCP Services
zentyal-openvpn – VPN Services
zentyal-webserver – Zentyal Web Server

Other modules which are not included in the profiles are as follows:

zentyal-bwmonitor – Zentyal Bandwidth Monitor
zentyal-captiveportal – Zentyal Captive Portal
zentyal-ips – Zentyal Intrusion Prevention System
zentyal-ipsec – Zentyal IPsec and L2TP/IPsec
zentyal-monitor – Zentyal Monitor
zentyal-nut – Zentyal UPS Management
zentyal-openchange – Zentyal OpenChange Server
zentyal-radius – Zentyal RADIUS
zentyal-software – Zentyal Software Management
zentyal-sogo – Zentyal OpenChange Webmail
zentyal-usercorner – Zentyal User Corner
zentyal-users – Zentyal Users and Computers
zentyal-webmail – Zentyal Webmail Service